11111111111111111111111
1E00C00000C000000000001
10100101001000000010101
10000101010100010000101
1P1000C00C00000000000C1
11111111111111111111111
